wwwwwwwwwwwww
w00000000000w
w00000000000C
w000000000000
w0000000000ww
w00000000wwww
w00000f000www
w0000www0000w
w00000ww0000w
www000000000w
ww0000000000w
w0000ww00000w
A00000000000w
00000000fwwww
wwww000wwwwww
wwwwwwwwwwwww