w@@@@@@@@@@@w
w00000000000w
w00000000000w
I00000000000K
000000f000000
ww00wwwww00ww
ww000www000ww
ww@@@www@@@ww