wwwwwwwwwwwww
w000r000s000w
w000r000s000w
B000r000s000w
0000r000s001w
ww00r000s00ww
wwwwwwwwwwwww
wwwwwwwwwwwww