w@@@@@@@@@@@@@@@@@@w
w000000000000000000w
w000000000000000000w
w000000000000000000w
w000000000000000000w
K000000000000000000w
0000000000000000000w
ww00wwwww00wwwww00ww
ww000www0000www000ww
ww@@@www@@@@www@@@ww