wwwwwwwwwwwwwwwwwwwwwwwwwwwwwwwwwwwwwww
w0000000000000000000000000000000000000w
w0000000000000000000000000000000000000w
w0000000000000000000000000000000000000w
w0000000000000000000000000000000000000w
w0000000000000000000000000000000000000w
w0000000000000000000000000000000000000w
w0000000000000000000000000000000000000w
w0000000000000000000000000000000000000w
w0000000000000000000000001000000000000w
w000000ww000rrr000sss000www00000000000w
C0000000w0000000000000000w000000000000w
00000w00000000000000000000000000000000w
ww000w0000000000000f000000000000000000w
www0000000wwwwwwwwwwwwwwww000000000wwww
wwwwwwwwwwwwwwwwwwwwwwwwwwwwwwwwwwwwwww
wwwwwwwwwwwwwwwwwwwwwwwwwwwwwwwwwwwwwww