wwwwwwwwwwwww
w00000000000w
w00000000000w
w00000000000L
w00000000000x
w0000000wwwww
w00000000wwww
w000000000www
w000000000www
w00000f00000w
w0000www0000w
w00000w00000w
w00000000000w
w00000000000w
w00000000000w
wwwww0000000w
www000000000w
ww0000000000w
ww0f00000000w
wwwwwwwww000w
wwwwwwwww000w
wwwwwwwww000w
wwwwwwwww000w
J000000ww000w
000000000000w
ww00000x00www
wwwwwwwwwwwww