wwwwwwwwwwwww
w000r000s000w
w000r000s000w
B000r000s000D
0000r000s0000
ww00r000s00ww
wwwwwwwwwwwww
wwwwwwwwwwwww