wwwwwwwwwwwww
w00000000000w
w00000000000w
w00000w00000w
w0000ww00000w
F00000000030w
00ww00x00wwww
wwwwwwwwwwwww