w@@@@@@@@@@@@
w00000000000@
w00000000000@
F00000000000@
000000000000@
wwww00000000@
wwww00000000@
www@@@@@@@@@@