wwwwwwwwwwwwwwwwwwwwwwwwwwwwwwwwwwwwwww
w0000000000000000000000000000000000000w
w0000000000000000000000000000000000000w
w0000000000000000000000000000000000000w
w0000000000000000000000000000000000000w
w0000000000000000000000000000000000000w
w0000000000000000000000000000000000000w
w000000000000000000000000000000000000ww
w00000000000000000000000000000000000www
w00000000000000000000000010000000000www
w000000ww000rrr000sss000www000000000www
C0000000w0000000000000000w0000000000www
00000w000000000000000000000000000000www
ww000w0000000000000f0000000000000000www
www0000000wwwwwwwwwwwwwwww0000000000www
wwwwwwwwwwwwwwwwwwwwwwwwwwwwwww00000www
wwwwwwwwwwwwwwwwwwwwwwwwwwwwwwwwwE0wwww