CCCCCCCCCCCCCCCCCCCCCCCCCCCCCCCCCCCCCCCCCCCCCCCCCCCCCCCCCCCCCCCCCCCCCCCCCCCCCCCCCCCCCCCCCCCCCCCCCCCCCCCCCCCCCCCCCCCCCCCCCCCCCCCCCCCCCN
CW0000000000000000000000000000000000000000000000000000000000000000000000000000000000000000000000000000000000000000000000000000000000CN
C0W000000000000000000000000000000000000000000000000000000000000000000000000000000000000000000000000000000000000000000000000000000000CN
C00W0000000000000000000000000000000000000000000000000000000000000000000000000000000000000000000000WWWWW00000000000000000000000000000CN
C000W0000000000000000000000000000000000000000000000000000000000000000000000000000000000000000000000W00WW000000WWWW000000000000000000CN
C0000W0000000000000000000000000000000000000000000000000000000000000WW00WW000000000000000000000WWW000000WWWW00000WWWW00000000000F0000CN
C0000000000000000000000000000000000000WW0000WWWW000000000000000000WWW00WWW000000WWWW00000000000W000000000000000000WW0000000000WWW000CN
C0000000000000000000000000000000000000WW00000WW0000000000000000WWWWW0000WWWWW000WWWWWW000000000000WWW00000000000000WW0000000WWWWWWW0CN
C000000000000000000000000000WWW000WW000000000000000WWWW00000000000000000000000000000WWWW00000000000W000000000000000WWWWWWWWWWWWWWWWWCN
C00000000000000WWWW00WWWW0000WW000000000000000000000000000WWW0000000000000000000000000WWWW0000WWW00000000000000000000000000000000000CN
C00P00000WWW000000000000000000WW00000000000000000000000000WWWW000000000000000000000000000000000WWW0000000000000000000000000000000000CN
C0WWW00WWWWWWWW000000000000000WW00000000000000000000000000WWWW000000000000000000000000000000000W000000000000000000000000000000000000CN
CCCCCCCCCCCCCCCCCCCCCCCCCCCCCCCCCCCCCCCCCCCCCCCCCCCCCCCCCCCCCCCCCCCCCCCCCCCCCCCCCCCCCCCCCCCCCCCCCCCCCCCCCCCCCCCCCCCCCCCCCCCCCCCCCCCCCN
