CCCCCCCCCCCCCCCCCCCCCCC
CW00000000000000000000C
C0W0000000000000000000C
C00W0000000000000WW000C
C000W00000000000000000C
C0000W00000000WW000000C
C000000000000000000000C
C00000000000000000WW00C
C000000000000000000000C
C00000000020000WWWW00WC
C00100000WWW0000000000C
C0WWW00WWWWWWWW0000000C
CCCCCCCCCCCCCCCCCCCCCCC