NNNNNNNNNNNNNNNNNNNNNNNNNNNNNNNNNNNNNNNNNNNNNNNNNNNNNNNNNNNNNNNNNNNNNNNNNNNNNNNNNNNNNNNNNNNNNNNNNNNNNNNNNNNNNNNNNNNNNNNNNNNNNNNNNNNNNNN
NCCCCCCCCCCCCCCCCCCCCCCCCCCCCCCCCCCCCCCCCCCCCCCCCCCCCCCCCCCCCCCCCCCCCCCCCCCCCCCCCCCCCCCCCCCCCCCCCCCCCCCCCCCCCCCCCCCCCCCCCCCCCCCCCCCCCCN
NC00000000000000000000000000000000000000000000000000000000000000000000000000000000000000000000000000000000000000000000000000000000000CN
NC00000000000000000000000000000000000000000000000000000000000000000000000000000000000000000000000000000000000000000000000000000000000CN
NC0000000000000000000000000000000000000000000000000000000000000000000000000000000000000000000000000WWWWW00000000000000000000000000000CN
NC00000000000000000000000000000000000000000000000000000000000000000000000000000000000000000000000000W00WW000000WWWW000000000000000000CN
NC000000000000000000000000000000000000000000000000000000000000000000WW00WW000000000000000000000WWW000000WWWW00000WWWW00000000000F0000CN
NC0000000000000000000000000000000000000WW0000WWWW000000000000000000WWW00WWW000000WWWW00000000000W000000000000000000WW0000000000WWW000CN
NC0000000000000000000000000000000000000WW00000WW0000000000000000WWWWW0000WWWWW000WWWWWW000000000000WWW00000000000000WW0000000WWWWWWW0CN
NC000000000000000000000000000WWW000WW000000000000000WWWW00000000000000000000000000000WWWW00000000000W000000000000000WWWWWWWWWWWWWWWWWCN
NC00000000000000WWWW00WWWW0000WW000000000000000000000000000WWW0000000000000000000000000WWWW0000WWW00000000000000000000000000000000000CN
NC00P00000WWW000000000000000000WW00000000000000000000000000WWWW000000000000000000000000000000000WWW0000000000000000000000000000000000CN
NC0WWW00WWWWWWW0000000000000000WW00000000000000000000000000WWWW000000000000000000000000000000000W000000000000000000000000000000000000CN
NCCCCCCCCCCCCCCCCCCCCCCCCCCCCCCCCCCCCCCCCCCCCCCCCCCCCCCCCCCCCCCCCCCCCCCCCCCCCCCCCCCCCCCCCCCCCCCCCCCCCCCCCCCCCCCCCCCCCCCCCCCCCCCCCCCCCCN
NNNNNNNNNNNNNNNNNNNNNNNNNNNNNNNNNNNNNNNNNNNNNNNNNNNNNNNNNNNNNNNNNNNNNNNNNNNNNNNNNNNNNNNNNNNNNNNNNNNNNNNNNNNNNNNNNNNNNNNNNNNNNNNNNNNNNNN